Conteonro,Fecha,Articulo,Logico,Fisico,Diferencia
C-02,1/10/2019,FOOTWEAR,103,100,-3
C-02,1/10/2019,FOOTWEAR,502,489,-13
C-02,1/10/2019,FOOTWEAR,123,130,7
C-02,1/10/2019,EQUIPMENT,325,315,-10
C-02,1/10/2019,EQUIPMENT,100,110,10
C-02,1/10/2019,EQUIPMENT,103,99,-4
C-02,1/10/2019,EQUIPMENT,153,200,47
C-02,1/10/2019,APPAREL,100,110,10
C-02,1/10/2019,APPAREL,300,298,-2
C-02,1/10/2019,APPAREL,110,105,-5
C-02,1/10/2019,APPAREL,120,135,15
